#P ###############################   ####|
##  #############################  ######|
###  ###########################  #######|
####   ########################  ########|
######  ######################  #########|
#######  ####################  ##########|
########  #######     ######  ###########|
#########  ######## #######  ############|
##########   ###### ######  #############|
############   ####S####   ############# |
##############    #####   ###############|
################   ###   ################|
##################     ##################|
##################   ####################|
                                         |
WWWWWWWWWWWWWWWWWWWWWWWWWWWWWWWWWWWWWWWWW|
+         +         +         +          |